+--+--+--+--+--+
         |     |
+--+--+  +--+  +
|        |     |
+  +--+--+  +  +
|           |  |
+--+--+  +--+  +
|     |  |     |
+  +  +--+  +--+
|  |            
+--+--+--+--+--+