+--+--+--+--+--+--+--+--+
            |           |
+  +--+--+  +  +--+--+  +
|  |     |     |        |
+  +  +--+--+--+  +--+--+
|  |           |  |     |
+  +  +--+--+  +  +  +--+
|  |  |     |     |     |
+  +  +  +--+--+--+--+  +
|  |     |     |     |  |
+  +--+--+  +  +  +  +  +
|  |        |     |     |
+  +  +--+--+--+--+--+  +
|     |        |     |  |
+  +--+  +--+  +  +--+  +
|        |     |         
+--+--+--+--+--+--+--+--+